.W..T...W
..W..R..R
.......R.
..S..W..R
....W.R..
S....R..W
...W.....
....T...S
W...W....
..R....R.
0,0
9,7
