..W....W..
.W.R..R...
..R...W...
.T..S....W
..R...RS..
.....T....
W.....R...
..R..W....
...S...W..
....W..R..
0,0
8,5