....S..W..
.T..W....R
W.....R..R
....R..W..
S....RW...
.RW...S...
....W.....
.R.....R..
.....W....
..T.......
0,0
9,3