.T..WR..W.
...R......
..W.SR..W.
.....W.R..
..W..W....
..T.S.....
W....R....
..R...WR..
......S...
....W..T..
0,0
0,8