...R..W...
....T....T
WR...ST...
.WW......S
......RR..
T..RW.....
.....R...S
SW....R.W.
....R..W..
.WT......T
0,0
6,8