..W..R...
.R..W..P.
T...S.W..
..R....W.
.....R...
R..W..S..
....R.T..
.W.......
..RW.....
..S.W....
0,0
6,7
