...W.S..R.
..W....W..
R..W..S...
.T.R......
.......W..
..R..RW...
...W......
...T..R...
.....W....
S....R....
0,0
9,4