.....R....
S....W..TW
..R.W.R...
.W.....W..
R...R....W
.T..SR..R.
.....W....
..W....T..
R.S....W..
.....R....
0,0
9,7