...R....W.
S..T...R..
..W..R..W.
...W......
WR....W...
....R...T.
..W..S....
.W.....W..
R....S....
.....R....
0,0
9,7