...W..W.T.
.....W.R..
..W....W..
..R.W...R.
S..WR..T.W
.R..S.....
...W......
R.....W...
......R...
S...W.....
0,0
8,8