...RS.....
....W..W.R
W....R.W..
..W....RS.
.....T..R.
..W.R.....
...W......
.T....W...
...W......
....T.....
0,0
8,7